XXXXXXXXXXXXXXXXXXSX
XXXXX              X
XXXXXXXXXXXXXXXXXX X
G                  X
XXXXX XXXXXXXXXXXX X
XXXXX XXXXXXXXXXXX X
XXXXX XXXXXXXXXXXXXX
XXXXX XXXXXXXXXXXX X
XXXXX       XXXXXX X
XXXXX XXXXXXXXXXXX X
XXXXX XXXXXXXXXXXX X
XXXXXXXXXXXXXXXXXX X
XXXXX              X
XXXXXXXXXXXXXXXX X X
XXXXX XXXXXXXXXX X X
XXXXX XXXXXXXXXX X X
X                X X
XXXXXXXXXXXXXXXXXX X
X                  X
XXXXXXXXXXXXXXXXXXXX