XXXXXXXXXXXXXXXXXXXX
XXX X XXX X XX XXX X
S      XX X    XX  X
XXX XX      XX    XX
XXX X  XXXXXXXX  XXX
X    X      XX  XXXX
XXX XXXXXXX   X XXXX
X   X  XXXXXXXX  X X
X XXXX  X          X
X       XXXXXXXXXX X
XX XXXX       XX   X
X      XXXXXX  X XXX
XXXXXX X   XXX X XXX
X        X     X   X
X  XXXXXXXXXXXXXX  X
X  X     X X       X
X    XX    X XX XXXX
XXXXXXXXXXXXXXX XXXX
G                  X
XXXXXXXXXXXXXXXXXXXX