XSXXXXXXXX
X X  X   X
X XX X XXX
X    X   X
XXXX   XXX
X    X   X
X XXXXX  X
X     XXXX
X  X     G
XXXXXXXXXX