XXXXXXXXSX
XXXXX    X
XXXXXXXX X
G        X
XXX XXXX X
XXX XXXX X
X      XXX
XXX XXXXXX
XXX XXXXXX
XXXXXXXXXX